44444444
44444440
44444444
44044444
44444444